#####################################
                                    #
                                    #
            Y         Y             #
       X         X        X         #
                                    #
#######    ###################      #
#                                   #
#                                   #
#           Y         Y             #
#      X         X         X        #
#                                   #
#      ##############################
#                                   #
#                                   #
#                                   #
#      X         X         X   YYY  #
#                                   #
#####################################

